####################
#                  #
# ################ #
# #    ####  #   # #
# # ####       #S# #
# # ####### ###### #
# #   #            #
# # ################
#     #   #        X
## # ### ## ########
## # # #  #    # # #
## # # # ## #### # #
## # # #  #      # #
## #   # ## ###### #
## ##### #   #     #
#      # # ##### ###
# #### # #       # #
# ###### #### #### #
#                  #
####################
